      (# # # # # # # # # # # # # #)
      (# # # # # # # # # # # # # #)
      (# . . . # # # # # # . . . #)
      (# . . . . . . . # # . . . #)
      (# . . . . . . . # # . . . #)
      (# . . . . . . . # # . . . #)
      (# . . . # # # # # # . . . #)
      (# . . . # # # # # # . . . #)
      (# . . . # # # # # # . . . #)
      (# . . . # # # # # # . . . #)
      (# . . . . . . . . . . . . #)
      (# . . . . . . . . . . . . #)
      (# . . . # # # # # # . . . #)
      (# . . . # # # # # # . . . #)
      (# . . . # . . . . # . . . #)
      (# . . . # . . . . # . . . #)
      (# . . . # . . . . # . . . #)
      (# . . . # . # . . # . . . #)
      (# . . . . . # . . # . . . #)
      (# . . . . . . . . # . . . #)
      (# . . . # . . . . # . . . #)
      (# . . . # . . . . # . . . #)
      (# . . . . . . . . . . . . #)
      (# . . . . . # . . . . . . #)
      (# . . . . . # . . . # . . #)
      (# . . . . . # # # . # . . #)
      (# . . . . . . # . . # . . #)
      (# . . . . . . . . . # . . #)
      (# . # # # # . . . . # . . #)
      (# . # # # # . . . . # . . #)
      (# . . . . . . . . . # . . #)
      (# . . . . . . . . . # . . #)
      (# . . . . . . . . . # . . #)
      (# . . . . . . . . . # . . #)
      (# . . . . . . . . . . . . #)
      (# . . . # # # # # # . . . #)
      (# . . . # # # # # # . . . #)
      (# . . . # # # # # # . . . #)
      (# . . . . . # # # # . . . #)
      (# . . . . . . . # # . . . #)
      (# . . . . # . . # # . . . #)
      (# . . . . . . . # # . . . #)
      (# . . . . . # # # # . . . #)
      (# . . . # # # # # # . . . #)
      (# . . . # # # # # # . . . #)
      (# . . . # # # # # # . . . #)
      (# . . . # # # # # # . . . #)
      (# . . . # # . . . . . . . #)
      (# . . . # # . . . . . . . #)
      (# . . . # # . . . . . . . #)
      (# # # # # # # # # # # # # #)
      (# # # # # # # # # # # # # #)
      
      # - 2
      . - 1